######
# O###
#  ###
#OP  #
#X X #
#  ###
######